ramshanm	Tech:Srv6;CnBng;
mkhaire	        Tech:Srv6;NSO/CNC;
aybalago	Tech:Srv6;CnBng;
rjagdale	Tech:Srv6;CnBng;OpenRAN;
arynair	        Tech:NSO/CNC;Clocking (PTP/SyncE);SR-CS and PLE;Security;Srv6;
nikgupt4	Tech:Srv6;NSO/CNC;Clocking (PTP/SyncE);
ankittya	Tech:NSO/CNC;Srv6;SR-CS and PLE;
pdikshit	Tech:Srv6;Clocking (PTP/SyncE);
snanda2	        Tech:CnBng;Security;NSO/CNC;SR-CS and PLE;Srv6;
rudsingh	Tech:Security;
mr2	        Tech:Srv6;OpenRAN;Security;NSO/CNC;
prmm    	Tech:Srv6;CnBng;Clocking (PTP/SyncE);NSO/CNC;OpenRAN;
swtrived	Tech:OpenRAN;NSO/CNC;Srv6;
rebalakr	Tech:Srv6;Clocking (PTP/SyncE);CnBng;
aratnani	Tech:Srv6;SR-CS and PLE;
rinkuria	Tech:Security;NSO/CNC;
apalde	        Tech:Security;
satydhar	Tech:Clocking (PTP/SyncE);CnBng;
subsalun	Tech:Clocking (PTP/SyncE);Security;NSO/CNC;
rukharch	Tech:Srv6;Clocking (PTP/SyncE);Security;SR-CS and PLE;
anushkja	Tech:Security;NSO/CNC;
Dharmeet 	Tech:Srv6;CnBng;NSO/CNC;
nradadiy	Tech:Srv6;OpenRAN;SR-CS and PLE;
shubhajain	Tech:NSO/CNC;
dhsirohi 	Tech:NSO/CNC;Srv6;
krmuvval	Tech:NSO/CNC;Security;
avalavi	        Tech:Srv6;CnBng;OpenRAN;
nikchava	Tech:Srv6;OpenRAN;
amerkuma	Tech:Srv6;Security;NSO/CNC;
Akshatp	        Tech:Srv6;Clocking (PTP/SyncE);SR-CS and PLE;
rudsingh	Tech:Security;
stsequei	Tech:Srv6;NSO/CNC;
